R 1000 800

NO ./texture/colorstone.xpm
SO ./texture/greystone.xpm
WE ./texture/purplestone.xpm
EA ./texture/redbrick.xpm
S ./texture/barrel.xpm

C 50,150,180

F 128,128,128

11111111111111111111111111111
10000000001100000000000000001
10110000011100020000000002001
10010020000000000000020010001
11111111101100000111000000011
10000000001100000111011100011
11110111111111011100000010001
11110111111111011101010010001
11000000110101011100000020001
10002000000020001100200000201
10000000000000000001010000001
11000001010101011111011100N01
11110111011101000101111010001
11111111111111111111111111111