R 600 600

NO ./texture/colorstone.xpm
SO ./texture/greystone.xpm
WE ./texture/purplestone.xpm
EA ./texture/redbrick.xpm
S ./texture/barrel.xpm

C 50,150,180

F 128,128,128

11111111111111111111111111111
10000000001100000000000010001
10110000011100020020000010001
100100000000002000000W0010001
11111111111100000111000001111
10000000001100000111011110111
11110111111111011100000010001
11110111111111011101010010001
10000000000000000000000000001
11000000110101011100000010201
10002000000000001100000010001
10000000000000000001010010001
11000001010101011111011110001
11110111011101010001111010001
11111111111111111111111111111